B5;B5;B5;B5;B5;B5;B5;B5;B5;B5;B5;B5;B5;B5;B5
A4;A4;0;A4;A4;0;A4;A4;0;A4;A4;0;A4;A4;A4
A3;0;A3;A3;0;A3;A3;A3;A3;A3;0;A3;A3;0;A3
A2;A2;0;A2;A2;0;A2;A2;0;A2;A2;0;A2;A2;A2
A1;0;A1;A1;0;A1;A1;A1;A1;A1;0;A1;A1;0;A1
A2;A2;0;A2;A2;0;A2;A2;0;A2;A2;0;A2;A2;A2
A3;0;A3;A3;0;A3;A3;A3;A3;A3;0;A3;A3;0;A3
A4;A4;0;A4;A4;0;A4;A4;0;A4;A4;0;A4;A4;A4
B5;B5;B5;B5;B5;B5;B5;B5;B5;B5;B5;B5;B5;B5;B5
