__;__;__;__;__;__;__;__;__;__;__;__;__;__;__
__;__;__;__;__;A3;A3;A3;A3;A3;__;__;A3;__;__
__;__;__;__;A3;A2;A2;B4;A2;A2;A3;A3;__;__;__
__;__;__;__;__;A3;A3;A3;A3;A3;__;__;A3;__;__
__;__;__;__;__;__;__;__;__;__;__;__;__;__;__
__;__;__;__;__;__;__;__;__;__;__;__;__;__;__
__;__;__;__;__;__;__;__;__;__;__;__;__;__;__
__;__;__;__;__;__;__;__;__;__;__;__;__;__;__