__;__;__;__;__;__;B5;__;B5;__;__;__;__;__;__
__;__;__;__;B5;__;B5;B5;B5;__;B5;__;__;__;__
__;__;__;B5;EX;B5;B5;EX;B5;B5;EX;B5;__;__;__
__;__;__;__;B5;B5;B5;B5;B5;B5;B5;__;__;__;__
__;__;__;__;__;B5;A3;B5;A3;B5;__;__;__;__;__
__;__;__;__;__;__;B5;EX;B5;__;__;__;__;__;__
__;__;__;__;__;__;__;B5;__;__;__;__;__;__;__
__;__;__;__;__;__;__;__;__;__;__;__;__;__;__