B5;B5;B5;B5;B5;B5;B5;B5;B5;B5;B5;B5;B5;B5;B5
A4;A4;A4;A4;0;0;EX;EX;EX;0;0;A4;A4;A4;A4
A3;EX;EX;0;A3;A3;0;B2;0;A3;A3;0;EX;EX;A3
A2;A2;0;A2;A2;0;A2;B1;A2;0;A2;A2;0;A2;A2
A1;0;A1;A1;0;B3;UB;UB;UB;B3;0;A1;A1;0;A1
A2;A2;0;A2;A2;0;A2;B1;A2;0;A2;A2;0;A2;A2
A3;0;A3;0;A3;A3;0;B2;0;A3;A3;0;A3;0;A3
A4;A4;A4;A4;0;0;A4;A4;A4;0;0;A4;A4;A4;A4
B5;EX;B5;B5;UB;B5;B5;B5;B5;B5;UB;B5;B5;EX;B5