EX;__;B4;__;EX;__;B4;__;EX;__;B4;__;EX;__;B4
__;B5;__;B5;__;B5;__;B5;__;B5;__;B5;__;B5;__
B4;__;EX;__;B4;__;EX;__;B4;__;EX;__;B4;__;EX
__;B5;__;B5;__;B5;__;B5;__;B5;__;B5;__;B5;__
EX;__;B4;__;EX;__;B4;__;EX;__;B4;__;EX;__;B4
__;B5;__;B5;__;B5;__;B5;__;B5;__;B5;__;B5;__
B4;__;EX;__;B4;__;EX;__;B4;__;EX;__;B4;__;EX
__;B5;__;B5;__;B5;__;B5;__;B5;__;B5;__;B5;__
__;__;__;__;__;__;__;__;__;__;__;__;__;__;__