__;__;__;__;__;__;__;__;__;__;__;__;__;__;__
__;B4;B4;B4;B4;B4;__;__;__;__;__;A1;__;__;__
__;__;__;B4;__;__;__;__;__;__;A1;A1;__;__;__
__;__;__;B4;__;__;UB;UB;__;A1;__;A1;__;__;__
__;__;__;B4;__;__;UB;UB;__;__;__;A1;__;__;__
__;__;__;B4;__;__;UB;UB;__;__;__;A1;__;__;__
__;__;__;B4;__;__;__;__;__;__;__;A1;__;__;__
__;__;__;B4;__;__;__;__;__;A1;A1;A1;A1;A1;__
__;__;__;__;__;__;__;__;__;__;__;__;__;__;__