UB;UB;UB;__;__;__;__;__;__;__;__;__;UB;UB;UB
UB;__;__;__;__;B5;__;__;__;B5;__;__;__;__;UB
UB;__;A1;__;__;__;B5;__;B5;__;__;__;A1;__;UB
__;__;__;A2;A2;A3;A3;B5;A3;A3;A2;A2;__;__;__
__;__;__;EX;__;__;B5;__;B5;__;__;EX;__;__;__
UB;__;A1;__;__;B5;__;__;__;B5;__;__;A1;__;UB
UB;__;__;__;__;__;__;__;__;__;__;__;__;__;UB
UB;UB;UB;__;__;__;__;__;__;__;__;__;UB;UB;UB